1 1 1 1 1 1 1 1 1 1 1 1 1 1 1 1 1 1 1 1 1 1 1
1 0 0 0 1 0 0 7 0 0 0 0 8 0 0 0 7 0 1 0 8 0 1
1 0 1 3 1 0 1 1 1 1 1 7 1 1 1 1 1 0 1 0 1 0 1
1 0 0 0 0 0 6 0 1 0 0 0 0 0 1 0 0 0 0 0 0 0 1
1 1 1 0 1 0 1 0 1 0 1 1 1 0 1 0 1 7 1 0 1 1 1
1 0 0 0 1 7 1 0 1 0 0 2 0 0 1 0 1 0 1 0 0 0 1
1 0 1 0 1 0 1 0 1 0 1 1 1 0 1 6 1 0 1 0 1 0 1
1 0 0 0 1 0 1 0 0 0 0 0 0 0 7 0 1 0 1 0 0 0 1
1 1 1 1 1 0 1 0 1 1 1 1 1 1 1 0 1 0 1 1 1 1 1
1 0 0 7 0 0 1 6 0 0 0 0 0 7 0 0 1 0 0 0 0 0 1
1 0 1 1 1 1 1 0 1 1 1 0 1 1 1 0 1 1 1 1 1 0 1
1 8 0 0 0 0 0 0 1 0 0 4 0 0 1 7 0 0 0 0 0 0 5
1 1 1 1 1 1 1 1 1 1 1 1 1 1 1 1 1 1 1 1 1 1 1
